|0, 1, 1, 1, 1, 1, 1, 
|1, 1, X, X, 1, 1, 1, 
|1, 1, 1, 1, 1, 1, 1, 
|1, 1, X, X, 1, 1, 1, 
|r, 1, 1, 1, 1, 1, 1, 
|X, X, X, X, X, X, X, 
