|r, 1, 1, 1, 1, 1, 1, 
|1, 1, X, X, X, 1, 1, 
|1, 1, 1, 1, 0, 1, 1, 
|1, 1, X, X, 0, 1, 1, 
|1, 1, 1, 0, 0, 1, 1, 
|X, X, X, 0, 0, X, X, 
